backache -- pain in your back
gatecrasher -- intruso
thirst -- sed
bedraggled -- wed and untidy
damp -- slightly wet
dribble -- gotear
chin -- barbilla
drool -- baba
salvage -- things: save what has value
joint -- articulación
doom -- sentenciar, condenar
brood -- worry, be upset
nod -- asentir
oncoming -- nearing, approaching
unforeseen -- unexpected
tan -- moreno
mottled -- blotchy (con manchas)
stain -- mancha en la ropa
slacks -- pantalón de vestir
hood -- capó de coche
chirpy -- cheerful (alegre)
listless -- apathetic
sour -- ácido o rancio
mephitic -- poisonous (mefítico)
clingy -- fabric: sticking to the body (ceñido, ajustado)
decaf -- decaffeinated coffee
NAACP -- National Association for the Advancement of Colored People
go under -- irse a pique un negocio
spew out -- escupir
menacing -- threatening (amenazador, amenazante)
restlessness -- agitación
ashen -- cenizo (cuando tienes ceniza)
akimbo -- with hands on hips
hips, hip -- cadera
hash -- guiso, estofado
hash browns -- croqueta de papa
hurling -- act of throwing sth (tiro, lanzamiento)
dank -- frío y húmedo, excelente
relentless -- firme, implacable

panhandler -- mendigo
hunker down -- instalarse, apoltronarse
haul -- long jorney
stroll -- pasear, dar una vuelta
wheeze -- respirar con dificultad
strain -- physical effort
flannel -- franela
perquisite -- benefit: of a job (gratificación, beneficio adicional)
plop [sth] down -- drop, place carelessly (tirar)
wayward -- person: wilful (caprichoso, obstinado)
long-sleeve shirt -- camisa de manga larga
assortment -- variety (selección, diversidad, surtido)
toiletries -- artículos de aseo personal
tote bag -- carryall (bolso de mano)
haunted -- encantado, poseido
haunted house -- casa encantada, casa embrujada
turnpike -- toll road (autopista de peaje)
venison -- deer meat (carne de ciervo)
marooned -- abandonado
scrounge -- gorronear
scrounge off [sb] -- vivir a costa de otros
exhilarating -- exciting, thrilling (estimulante, excitante)
half-cocked -- con el seguro echado, mal concebido
leap out at [sb] -- saltar a la vista, ser evidente
switchboard -- centralita, conmutador
condo -- (from condominium) bloque de apartamentos
affluent -- wealthy
ramshackle -- en ruinas
boardinghouse -- pensión
chuckle -- soltar una risita
unmade -- bed: with untidy sheets (sin hacer)
ceiling -- techo
roof -- tejado
grave -- tumba
pier -- muelle, embarcadero
reassure -- explain [sth] is OK
putative -- supposed, reported (supuesto, aparente)
jolly -- cheerful (alegre, feliz)
gal -- chica
linen -- ropa de hogar
dishware -- vajilla
cottage -- small house (cabaña, casita de campo)
due -- expected (hacer falta)
glimpse -- see briefly
clerical -- de oficina
wardrobe -- armario
without so much as -- sin apenas
so much as -- apenas
conveyor belt -- cinta transportadora
dough -- masa
warehouse -- almacén
misshapen -- deforme
fellow -- tio (coloquial)
tuck -- doblar, plegar, meter
balefully -- menacingly (de manera amenazante)
ward [sb/sth] -- repeler, mantener a raya
nonchalant -- tranquilo, calmado
flustered -- aturdida
flippant -- superficial, poco serio, frívolo
startling -- deslumbrante, sorprendente
furrow your brow -- fruncir el ceño
sprinkling -- small quantity scattered (poco, pizca)
dingy -- dark, gloomy (sucio, lóbrego)
noon -- mediodía
maid -- domestic servant (criada, sirvienta)
congenial -- agradable
aide -- assistant (asistente, auxiliar)
hairnet -- mesh head covering
apron -- mandil, delantal
at your own discretion -- según te parezca mejor
put up with [sb/sth] -- tolerate (tolerar, aguantar)
screwup -- cagada
endanger -- life or person: put in danger
slippery -- resbaladizo
hazardous -- peligroso
afterwards -- after that
stiffly -- not freely or easily (rigidamente)
scuffle -- pelear, reñir
undies -- informal way of saying 'underwear'
take a dump, have a dump -- echar una cagada
clutch [sth] -- hold [sth] firmly
diaper -- pañal
waist -- cintura
sneak -- informal way of saying 'steal'
hoot -- reírse a carcajadas
scrape -- raspar, arañar
rinse -- enjuagar
pre-soak -- remojar con antelación
dish rack -- escurreplatos
straggler -- [sb] who is lagging behind (rezagado)
postprandial -- después de la comida, de sobremesa
in timely fashion -- quickly, promptly, within a reasonable time frame
craven -- cowardly (cobarde)
stab -- attack with a knife
come down on [sb] -- agarrarla con alguien
slip -- resbalarse, escurrirse
carouse -- celebrate drunkenly (salir de fiesta)
goody-goody -- informal, pejorative way of saying 'well-behaved' (santo)
on account of [sth] -- because of, due to (debido a)
wreck -- chatarra
scraggly -- desaliñado
stir-crazy -- restless from being confined indoors (loco)
outcast -- rejected (marginado)
brace yourself -- prepararse, estar listo para algo inminente
sentient -- conscious, aware
take attendance -- pasar lista
grip -- agarrar, sujetar
steak -- bistec
beef -- meat from cow or steer
accolade -- praise (elogio)
RN -- abbreviation of 'Registered Nurse' (enfermero, enfermera)
beacon -- signal from lighthouse (faro)
facility -- building, unit (instalación)
fiend -- evil spirit (demonio, diablo)
soak -- poner en remojo, empapar
groin -- ingle
erstwhile -- former (antiguo, de otra época)
cackle -- laugh noisily (reírse a carcajadas)
admirer -- suitor of woman (pretendiente de una mujer)
crush -- large throng, crowd (multitud) * press with destructive force (machucar, apretar)
means -- resources (medios)
thoroughly -- informal way of saying 'completely, totally'
sign -- letrero
tent -- carpa
warehouse -- almacén
deserted -- abandonado, descuidado
looming -- inminente
dusk -- twilight (anochecer)
hillbilly -- palurdo
redneck -- paleto
maiden -- unmarried girl
sway -- balancearse, mecerse
onset -- start, beginning (comienzo, arranque)
rapturously -- con entusiasmo
preaching -- sermón religioso
commence -- formal way of saying 'begin'
shirtsleeve -- arm part of a shirt (manga de camisa)
marvelous -- maravilloso, excelente
bemoan [sth] -- complain about
secular -- not religious (seglar, secular)
mike -- abbreviation of microphone
wicked -- mean, evil (malvado, retorcido)
hip -- cadera
squad -- sports team
indwells -- live within (morar)
standpoint -- point of view
rousing -- emotionally stirring, motivational
corpse -- dead body (cadáver)
vagrant -- homeless person (vagabundo)
gag -- cloth, etc., in or on mouth (amordazar)
tether [sth] to [sth] -- fasten, attach (atar)
fasten [sth] -- atar con cuerda
shortcoming -- person: fault, flaw (defectos, fallas)
endearing -- lovable (adorable)
creep -- crawl
